url	download_complete
www.ics.uci.edu/ugrad	complete
www.ics.uci.edu/~emilyo	incomplete
www.ics.uci.edu/~nicolau	incomplete
www.ics.uci.edu/prospective/vi/degrees/software-engineering	incomplete
www.ics.uci.edu/computing/services/msoffice.php	complete
www.stat.uci.edu	incomplete
www.ics.uci.edu/about/search	incomplete
www.ics.uci.edu/computing/contact/staff.php	complete
ngs.ics.uci.edu	incomplete
www.ics.uci.edu/computing/linux/modules.php	complete
sconce.ics.uci.edu	incomplete
www.ics.uci.edu/prospective/zh-tw/opportunities/applied-learning	incomplete
www.ics.uci.edu/~craigga	incomplete
www.ics.uci.edu/community/news/view_news?id=1198	incomplete
www.socsci.uci.edu/~jkrichma/CARL/index.html	incomplete
www.ics.uci.edu/involved/leadership_council	complete
www.ics.uci.edu/prospective/zh-tw/degrees/computer-science-engineering	incomplete
www.artificialbrains.com/darpa-synapse-program	incomplete
netreg.ics.uci.edu	complete
mcs.ics.uci.edu/current-students/resources/policies	incomplete
www.ics.uci.edu/~ohaimson	incomplete
www.ics.uci.edu/~mjcarey	incomplete
mcs.ics.uci.edu/current-students/resources/grad-student-handbook	incomplete
instagram.com/ucibrenics	incomplete
www.ics.uci.edu/faculty/profiles/view_faculty.php?ucinetid=smehrotr	incomplete
www.ics.uci.edu/~bdonyana	incomplete
www.ics.uci.edu/faculty/profiles/view_faculty.php?ucinetid=tanenbaj	incomplete
www.ics.uci.edu/computing/policy	complete
www.ics.uci.edu/statistics/grad/index.php	complete
elms.ics.uci.edu	incomplete
www.ics.uci.edu/computing/services/microsoft_imagine.php	complete
www.ics.uci.edu/prospective/zh-tw/careers/breadth	incomplete
www.ics.uci.edu/prospective/en/degrees/software-engineering	complete
www.ics.uci.edu/faculty/profiles/view_faculty.php?ucinetid=judithgr	incomplete
www.ics.uci.edu/faculty/profiles/view_faculty.php?ucinetid=bruberg	incomplete
www.ics.uci.edu/~bermanb	incomplete
calendar.ics.uci.edu/calendar.php	incomplete
mcs.ics.uci.edu/advisory-board	incomplete
www.ics.uci.edu/~gbowker	incomplete
www.ics.uci.edu/faculty/profiles/view_faculty.php?ucinetid=standish	incomplete
www.ics.uci.edu/~emj	incomplete
www.ics.uci.edu/faculty/profiles/view_faculty.php?ucinetid=yuzhaoxia	incomplete
ugradforms.ics.uci.edu	incomplete
www.ics.uci.edu/~sbaidya	complete
www.ics.uci.edu/community/news/view_news?id=1249	incomplete
www.ics.uci.edu/~bvegetab	incomplete
www.nasa.gov/researchpark	incomplete
www.ics.uci.edu/community/news/view_news?id=1245	incomplete
www.ics.uci.edu/~jlettner	incomplete
www.ics.uci.edu/computing/account/faqs.php	complete
www.ics.uci.edu/community/news/view_news?id=1246	incomplete
www.ics.uci.edu/community/news/view_news?id=1241	incomplete
www.ics.uci.edu/community/news/view_news?id=1240	incomplete
www.ics.uci.edu/community/news/view_news?id=1243	incomplete
www.ics.uci.edu/community/news/view_news?id=1242	incomplete
www.ics.uci.edu/~stasio	incomplete
www.ics.uci.edu/faculty/profiles/view_faculty.php?ucinetid=hziv	incomplete
www.ics.uci.edu/computing/account/mapdrive_win.php	complete
www.ics.uci.edu/prospective/en/careers/breadth	complete
www.ics.uci.edu/prospective/vi/contact/student-affairs	incomplete
www.ics.uci.edu/~kroher	incomplete
www.ics.uci.edu/community/news/view_news?id=1286	incomplete
www.ics.uci.edu/ugrad/degrees/Minors	complete
www.ics.uci.edu/prospective/zh-tw/uci/campus	incomplete
mhcid.ics.uci.edu/people/current-students	incomplete
mcs.ics.uci.edu/faq	incomplete
www.ics.uci.edu/community/news/view_news?id=1131	incomplete
www.ics.uci.edu/prospective/ko/degrees/informatics	incomplete
www.ics.uci.edu/community/news/view_news?id=1238	incomplete
www.ics.uci.edu/community/news/view_news?id=1239	incomplete
www.ics.uci.edu/~jnnorton	incomplete
www2.clustrmaps.com/user/208110dd8	incomplete
www.ics.uci.edu/community/news/view_news?id=1230	incomplete
www.ics.uci.edu/community/news/view_news?id=1231	incomplete
www.ics.uci.edu/prospective/zh-tw	complete
www.ics.uci.edu/community/news/view_news?id=1233	incomplete
www.ics.uci.edu/community/news/view_news?id=1234	incomplete
www.ics.uci.edu/community/news/view_news?id=1235	incomplete
www.ics.uci.edu/community/news/view_news?id=1236	incomplete
www.ics.uci.edu/community/news/view_news?id=1237	incomplete
www.ics.uci.edu/prospective/en/uci/student-services	incomplete
www.ics.uci.edu/~jseberge	incomplete
www.ics.uci.edu/computing/services/restore.php	complete
www.ics.uci.edu/faculty/profiles/view_faculty.php?ucinetid=hombao	incomplete
www.ics.uci.edu/computing/services/snapshot.php	complete
www.ics.uci.edu/computing/linux/hosts.php	complete
mcs.ics.uci.edu/contact-us/staff	incomplete
www.ics.uci.edu/grad/funding	incomplete
www.ics.uci.edu/faculty/profiles/view_faculty.php?ucinetid=ddenenbe	incomplete
darpahackfest.com/introduction	incomplete
www.ics.uci.edu/~sjordan	complete
www.ics.uci.edu/prospective/zh-tw/degrees/overview	incomplete
www.ics.uci.edu/prospective/zh-tw/degrees/software-engineering	incomplete
www.ics.uci.edu/ugrad/policies/Grade_Options	complete
www.ics.uci.edu/prospective/en/degrees/informatics	complete
mhcid.ics.uci.edu/people/mhcid-faculty-and-staff	incomplete
www.ics.uci.edu/faculty/profiles/view_faculty.php?ucinetid=wscacchi	incomplete
www.ics.uci.edu/grad	complete
honors.ics.uci.edu	incomplete
www.ics.uci.edu/~hinaa	incomplete
www.ics.uci.edu/~jpd	incomplete
hombao.ics.uci.edu	incomplete
www.ics.uci.edu/~dillenco	incomplete
mcs.ics.uci.edu	incomplete
www.ics.uci.edu/%7Edjr/DebraJRichardson/SE4S.html	complete
www.ics.uci.edu/grad/admissions/index	complete
upload.wikimedia.org/wikipedia/commons/0/07/Hyraxchewing.ogv	incomplete
www.ics.uci.edu/faculty/profiles/view_faculty.php?ucinetid=vminin	incomplete
www.ics.uci.edu/faculty/profiles/view_faculty.php?ucinetid=mizukoi	incomplete
www.civilization.com	incomplete
www.ics.uci.edu/prospective/en/admissions/freshmen	complete
www.ics.uci.edu/~kay	incomplete
www.ics.uci.edu/ugrad/policies/Academic_Standing	complete
www.ics.uci.edu/ugrad/courses/index	complete
www.ics.uci.edu/~dgillen	incomplete
www.ics.uci.edu/computing/network	complete
www.ics.uci.edu/faculty/highlights	complete
www.monash.edu/5icc	incomplete
www.ics.uci.edu/faculty/profiles/view_faculty.php?ucinetid=guoqingx	incomplete
www.ics.uci.edu/faculty/profiles/view_faculty.php?ucinetid=avanderh	incomplete
www.ics.uci.edu/prospective/en/contact/student-affairs	complete
www.ics.uci.edu/computing	incomplete
mcs.ics.uci.edu/contact-us/faculty	incomplete
www.uadv.uci.edu/DonaldBrenSchoolOfICSAnnualGiving	incomplete
futurehealth.ics.uci.edu	incomplete
facebook.com/UCIBrenICS	incomplete
www.ics.uci.edu/faculty/profiles/view_faculty.php?ucinetid=sameer	incomplete
www.ics.uci.edu/community/news/press/view_press?id=122	incomplete
www.ics.uci.edu/ugrad/resources/index	complete
www.ics.uci.edu/~skmahara	incomplete
www.ics.uci.edu/~andre	incomplete
www.ics.uci.edu/community	complete
streetfighter.com	incomplete
www.ics.uci.edu/prospective/vi/admissions/freshmen	incomplete
www.ics.uci.edu/~isaac	incomplete
en.wikipedia.org/wiki/Software-defined_radio	incomplete
www.ics.uci.edu/%7elab/lab_schedule	complete
ucirvine-csm.symplicity.com/index.php/pid700104	incomplete
support.ics.uci.edu/passwd	incomplete
mhcid.ics.uci.edu/program/capstone-projects	incomplete
www.ics.uci.edu/prospective/vi/opportunities/research	incomplete
www.ics.uci.edu/faculty/profiles/view_faculty.php?ucinetid=chenli	incomplete
www.ics.uci.edu/%7eprojects/cert	incomplete
www.ics.uci.edu/~klefstad	incomplete
www.ics.uci.edu/computing/account/new	complete
support.ics.uci.edu/ltb	incomplete
mcs.ics.uci.edu/about/course-descriptions	incomplete
www.ics.uci.edu/faculty/profiles/view_faculty.php?ucinetid=sudderth	incomplete
www.ics.uci.edu/community/events	incomplete
www.ics.uci.edu/prospective/ko/degrees/data-science	incomplete
www.ics.uci.edu/community/news/view_news?id=1183	incomplete
radicle.ics.uci.edu	complete
www.ics.uci.edu/community/news/view_news?id=1229	incomplete
www.ics.uci.edu/grad/admissions	complete
www.darksouls3.com/us	incomplete
www.ics.uci.edu/community/news/view_news?id=1179	incomplete
www.ics.uci.edu/community/news/view_news?id=1178	incomplete
www.ics.uci.edu/community/news/view_news?id=1173	incomplete
www.ics.uci.edu/community/news/view_news?id=1172	incomplete
www.ics.uci.edu/community/news/view_news?id=1171	incomplete
www.ics.uci.edu/community/news/view_news?id=1170	incomplete
www.ics.uci.edu/community/news/view_news?id=1177	incomplete
www.ics.uci.edu/community/news/view_news?id=1176	incomplete
www.ics.uci.edu/community/news/view_news?id=1175	incomplete
www.ics.uci.edu/community/news/view_news?id=1274	incomplete
www.ics.uci.edu/community/news/view_news?id=1275	incomplete
www.ics.uci.edu/community/news/view_news?id=1276	incomplete
www.ics.uci.edu/community/news/view_news?id=1277	incomplete
www.ics.uci.edu/community/news/view_news?id=1270	incomplete
www.ics.uci.edu/about	complete
www.ics.uci.edu/community/news/view_news?id=1272	incomplete
www.ics.uci.edu/community/news/view_news?id=1273	incomplete
www.ics.uci.edu/prospective/en/student-life/diversity	complete
www.ics.uci.edu/community/news/view_news?id=1278	incomplete
www.ics.uci.edu/community/news/view_news?id=1279	incomplete
www.ics.uci.edu/~jsolson	incomplete
www.ics.uci.edu/%7esysarch	incomplete
www.ics.uci.edu/~anamakis	incomplete
embedded.kookmin.ac.kr?p=28	incomplete
www.ics.uci.edu/faculty/profiles/view_faculty.php?ucinetid=djr	incomplete
www.ics.uci.edu/ugrad/resources	incomplete
www.ics.uci.edu/community/news/view_news?id=1221	incomplete
www.ics.uci.edu/grad/courses	incomplete
www.ics.uci.edu/community/alumni	complete
www.ics.uci.edu/faculty/profiles/view_faculty.php?ucinetid=whayes	incomplete
mcs.ics.uci.edu/current-students/course-outline	incomplete
www.ics.uci.edu/ugrad/QA_Graduation	complete
www.ics.uci.edu/ugrad/policies/CS199_IN4MATX199	complete
www.ics.uci.edu/~yamingy	incomplete
www.ics.uci.edu/faculty/profiles/view_faculty.php?ucinetid=ebozorgz	incomplete
www.ics.uci.edu/faculty/profiles/view_faculty.php?ucinetid=zhengkai	incomplete
www.ics.uci.edu/~ziv	incomplete
www.ics.uci.edu/prospective/zh-tw/student-life/diversity	incomplete
www.ics.uci.edu/about/equity	complete
www.ics.uci.edu/~dfooshee	incomplete
mailman.ics.uci.edu/mailman/listinfo	incomplete
www.ics.uci.edu/~alexv	incomplete
www.ics.uci.edu/~ardalan	incomplete
www.ics.uci.edu/faculty/profiles/view_faculty.php?ucinetid=shz	incomplete
www.ics.uci.edu/prospective/vi/opportunities/applied-learning	incomplete
www.ics.uci.edu/faculty/profiles/view_faculty.php?ucinetid=dfkibler	incomplete
www.ics.uci.edu/~fowlkes	incomplete
www.ics.uci.edu/about/brenhall/index.php	complete
www.ics.uci.edu/computing/quarterlyAnnouncement/index.php	complete
www.ics.uci.edu/~djr	incomplete
www.ics.uci.edu/faculty/profiles/view_faculty.php?ucinetid=majumder	incomplete
www.ics.uci.edu/~dechter	incomplete
www.ics.uci.edu/involved	complete
www.ics.uci.edu/~lab/lab_schedule	incomplete
www.ics.uci.edu/faculty/index.php	incomplete
www.ics.uci.edu/faculty/profiles/view_faculty.php?ucinetid=nalini	incomplete
www.ics.uci.edu/community/news/view_news?id=1258	incomplete
www.ics.uci.edu/faculty/profiles/view_faculty.php?ucinetid=fowlkes	incomplete
www.ics.uci.edu/computing/linux/shell.php	complete
www.ics.uci.edu/%7elab/students/acct_activate.php	incomplete
www.ics.uci.edu/faculty/profiles/view_faculty.php?ucinetid=yunanc	incomplete
www.ics.uci.edu/statistics	incomplete
www.ics.uci.edu/prospective/zh-tw/opportunities/honors	incomplete
www.ics.uci.edu/~majumder	incomplete
thewitcher.com/en/witcher3	incomplete
www.ics.uci.edu/about/visit	incomplete
www.ics.uci.edu/community/news/view_news?id=1259	incomplete
www.ics.uci.edu/faculty/profiles/view_faculty.php?ucinetid=rickl	incomplete
www.ics.uci.edu/ugrad/sao/Course_updates	complete
mhcid.ics.uci.edu/program/events	incomplete
embedded.kookmin.ac.kr	incomplete
www.ics.uci.edu/~xhx	incomplete
www.variability.org	incomplete
emj.ics.uci.edu/papers/machine-learning-papers	incomplete
www.ics.uci.edu/prospective/en/opportunities/applied-learning	complete
www.cs.uci.edu	incomplete
www.ics.uci.edu/prospective/ko/opportunities/research	incomplete
www.ics.uci.edu/~irani	incomplete
www.ics.uci.edu/~sharad	incomplete
www.ics.uci.edu/prospective/ko/opportunities/honors	incomplete
www.ics.uci.edu/~mlevorat/ 	incomplete
www.ics.uci.edu/faculty/profiles/view_faculty.php?ucinetid=jsolson	incomplete
www.ics.uci.edu/faculty/profiles/view_faculty.php?ucinetid=pattis	incomplete
www.ics.uci.edu/%7Emlevorat	incomplete
mhcid.ics.uci.edu/people/mentors	incomplete
www.ics.uci.edu/faculty/profiles/view_faculty.php?ucinetid=dfredmil	incomplete
www.ics.uci.edu/~dan	incomplete
www.ics.uci.edu/faculty/profiles/view_faculty.php?ucinetid=marios	incomplete
www.linkedin.com/in/davide-callegaro?locale=en_US	incomplete
www.ics.uci.edu/prospective/vi/opportunities/entrepreneurship	incomplete
www.cs.uci.edu/wp-content/cs/uploads/ACD_3958-1.jpg	incomplete
www.ics.uci.edu/~smyth	incomplete
www.ics.uci.edu/community/news/view_news?id=1271	complete
www.ics.uci.edu/~feldman	incomplete
www.ics.uci.edu/~diy4	incomplete
www.ics.uci.edu/computing/linux/security.php	complete
www.ics.uci.edu/~hyungiko	incomplete
www.ics.uci.edu/prospective/zh-tw/opportunities/research	incomplete
www.ics.uci.edu/faculty/profiles/view_faculty.php?ucinetid=dgillen	incomplete
www.ics.uci.edu/faculty/profiles/view_faculty.php?ucinetid=levorato	incomplete
www.ics.uci.edu/~guix	incomplete
www.ics.uci.edu/prospective/zh-tw/opportunities/entrepreneurship	incomplete
www.ics.uci.edu/faculty/profiles/view_faculty.php?ucinetid=const	incomplete
www.ics.uci.edu/~eppstein	incomplete
www.ics.uci.edu/community/news/view_news?id=1137	incomplete
www.ics.uci.edu/grad/funding/index	complete
www.ics.uci.edu/community/news/view_news?id=1135	incomplete
www.ics.uci.edu/community/news/view_news?id=1134	incomplete
www.ics.uci.edu/community/news/view_news?id=1133	incomplete
www.ics.uci.edu/community/news/view_news?id=1132	incomplete
www.ics.uci.edu/prospective/vi/degrees/computer-game-science	incomplete
www.ics.uci.edu/community/news/view_news?id=1130	incomplete
www.ics.uci.edu/~gopi	incomplete
www.ics.uci.edu/~mmazmani	incomplete
www.ics.uci.edu/prospective/ko/degrees/minors	incomplete
www.ics.uci.edu/community/news/view_news?id=1139	incomplete
www.ics.uci.edu/community/news/view_news?id=1138	incomplete
www.ics.uci.edu/facebook	complete
mcs.ics.uci.edu/about/mcs-vs-mscs	incomplete
cml.ics.uci.edu	incomplete
www.ics.uci.edu/faculty/profiles/view_faculty.php?ucinetid=aveidenb	incomplete
www.ics.uci.edu/faculty/profiles/view_faculty.php?ucinetid=nardi	incomplete
www.ics.uci.edu/faculty/profiles/view_faculty.php?ucinetid=isaac	incomplete
www.ics.uci.edu/prospective/ko/contact/student-affairs	incomplete
www.ics.uci.edu/community/news/view_news?id=1252	incomplete
www.ics.uci.edu/~enalisni	incomplete
www.ics.uci.edu/~mirzaeib	incomplete
www.ics.uci.edu/community/news/view_news?id=1182	incomplete
www.ics.uci.edu/prospective/en/uci/campus	complete
www.ics.uci.edu/community/news/view_news?id=1180	incomplete
www.ics.uci.edu/community/news/view_news?id=1228	incomplete
www.ics.uci.edu/community/news/view_news?id=1186	incomplete
www.ics.uci.edu/community/news/view_news?id=1187	incomplete
mhcid.ics.uci.edu/program/curriculum	incomplete
www.ics.uci.edu/community/news/view_news?id=1185	incomplete
www.ics.uci.edu/community/news/view_news?id=1223	incomplete
www.ics.uci.edu/community/news/view_news?id=1222	incomplete
www.ics.uci.edu/community/news/view_news?id=1188	incomplete
www.ics.uci.edu/community/news/view_news?id=1220	incomplete
www.ics.uci.edu/community/news/view_news?id=1227	incomplete
www.ics.uci.edu/community/news/view_news?id=1226	incomplete
www.ics.uci.edu/community/news/view_news?id=1225	incomplete
www.ics.uci.edu/community/news/view_news?id=1224	incomplete
www.ics.uci.edu/faculty/profiles/view_faculty.php?ucinetid=jajones	incomplete
swiki.ics.uci.edu/doku.php/services:webmail	incomplete
www.ics.uci.edu/ugrad/policies/Add_Drop_ChangeOption	complete
www.ics.uci.edu/ugrad/sao	complete
www.ics.uci.edu/%7elab	complete
www.ics.uci.edu/faculty/profiles/view_faculty.php?ucinetid=gbowker	incomplete
www.ics.uci.edu/~sudderth	incomplete
www.ics.uci.edu/~stauro	incomplete
www.ics.uci.edu/~forouzme	incomplete
www.ics.uci.edu/community/news/press	complete
www.ics.uci.edu/prospective/zh-tw/degrees/business-information-management	incomplete
www.ics.uci.edu/community/news/view_news?id=1248	incomplete
www.ics.uci.edu/community/news/view_news?id=1192	incomplete
www.ics.uci.edu/community/news/view_news?id=1292	incomplete
www.ics.uci.edu/community/news/view_news?id=1290	incomplete
www.ics.uci.edu/community/news/view_news?id=1291	incomplete
www.ics.uci.edu/faculty/profiles/view_faculty.php?ucinetid=sjordan	incomplete
www.ics.uci.edu/computing/contact	complete
www.ics.uci.edu/~rickl	incomplete
www.ics.uci.edu/grad/courses/index	complete
www.ics.uci.edu/bin/pdf/grad/F17-18%20Graduate%20Student%20Handbook.pdf	complete
www.ics.uci.edu/community/news/view_news?id=1244	incomplete
www.ics.uci.edu/~yunanc	incomplete
www.ics.uci.edu/community/news/view_news?id=1247	incomplete
www.esports.uci.edu/uci-esports-arena.php	incomplete
www.ics.uci.edu/faculty/profiles/view_faculty.php?ucinetid=trammell	incomplete
www.ucr.edu	incomplete
www.ics.uci.edu/community/events/competition	complete
mcs.ics.uci.edu/career/finding-a-job-internship	incomplete
darpahackfest.com	incomplete
www.ics.uci.edu/community/news/view_news?id=1129	incomplete
www.ics.uci.edu/community/scholarships	incomplete
www.ics.uci.edu/prospective/vi/degrees/computer-science-engineering	incomplete
vision.ics.uci.edu	incomplete
www.ics.uci.edu/faculty/index.php?letter=T	incomplete
www.ics.uci.edu/prospective/en/degrees/computer-science	complete
www.ics.uci.edu/computing/account/quota.php	complete
www.nintendo.com/games/detail/monster-hunter-generations-3ds	incomplete
www.linkedin.com/company/uc-irvine-information-and-computer-sciences	incomplete
www.ics.uci.edu/%7edgillen	complete
www.ics.uci.edu/prospective/vi/degrees/data-science	incomplete
youtube.com/UCIBrenICS	incomplete
www.ics.uci.edu/community/news/view_news.php?id=1264	complete
www.ics.uci.edu/~eugenig	incomplete
www.ics.uci.edu/faculty	complete
www.ics.uci.edu/informatics	incomplete
www.ics.uci.edu/about/search/index.php	complete
www.ics.uci.edu/computing/email/group_email.php	complete
www.ics.uci.edu/computing/email	complete
www.ics.uci.edu/~harris	incomplete
www.cecs.uci.edu	incomplete
www.ics.uci.edu/~nalini	incomplete
www.ics.uci.edu/faculty/profiles/view_faculty.php?ucinetid=thornton	incomplete
www.ics.uci.edu/prospective	complete
www.ics.uci.edu/~dutt	incomplete
www.ics.uci.edu/community/news/view_news?id=1211	incomplete
www.ics.uci.edu/~lab	complete
www.ics.uci.edu/computing/policy/ethics_summary.php	complete
www.ics.uci.edu/ugrad/index	complete
www.ics.uci.edu/community/news/press/view_press?id=160	incomplete
www.ics.uci.edu/prospective/vi/student-life/diversity	incomplete
www.ics.uci.edu/~boyanw1	incomplete
www.ics.uci.edu/~wmt	incomplete
mcs.ics.uci.edu/career/international-students	incomplete
www.ics.uci.edu/ICS/ics/community/events/competition	incomplete
mhcid.ics.uci.edu/people/mhcid-current-students	incomplete
www.ics.uci.edu/~mlevorat	incomplete
www.ics.uci.edu/~jesmaeln	incomplete
www.ics.uci.edu/prospective/ko	complete
www.ics.uci.edu/~gmark	incomplete
www.ics.uci.edu/ugrad/policies/Course_Outside_UCI	complete
www.ics.uci.edu/~chenli	incomplete
www.ics.uci.edu/~franz	incomplete
www.ics.uci.edu/~kibler	incomplete
www.ics.uci.edu/~standish	incomplete
www.ics.uci.edu/faculty/profiles/view_faculty.php?ucinetid=ksquire	incomplete
www.ics.uci.edu/prospective/en/careers/alumni	incomplete
www.ics.uci.edu/~jajones	incomplete
www.ics.uci.edu/faculty/profiles/view_faculty.php?ucinetid=emj	incomplete
www.ics.uci.edu/community/news/view_news?id=1256	complete
intranet.ics.uci.edu	complete
www.ics.uci.edu/about/brenhall	complete
www.ics.uci.edu/faculty/profiles/view_faculty.php?ucinetid=rwblack	incomplete
mhcid.ics.uci.edu/admissions/admissions-overview	incomplete
www.ics.uci.edu/about/about_deanmsg.php	complete
www.ics.uci.edu/faculty/index.php?letter=C	incomplete
www.ics.uci.edu/faculty/index.php?letter=B	incomplete
www.ics.uci.edu/faculty/index.php?letter=A	incomplete
mcs.ics.uci.edu/career/interviewing	incomplete
www.ics.uci.edu/faculty/index.php?letter=G	incomplete
www.ics.uci.edu/faculty/index.php?letter=F	incomplete
www.ics.uci.edu/faculty/index.php?letter=E	incomplete
www.ics.uci.edu/faculty/index.php?letter=D	incomplete
www.ics.uci.edu/faculty/index.php?letter=K	incomplete
www.ics.uci.edu/faculty/index.php?letter=J	incomplete
www.ics.uci.edu/faculty/index.php?letter=I	incomplete
www.ics.uci.edu/faculty/index.php?letter=H	incomplete
www.ics.uci.edu/faculty/index.php?letter=O	incomplete
www.ics.uci.edu/faculty/index.php?letter=N	incomplete
www.ics.uci.edu/computing/account/new.php	complete
www.ics.uci.edu/faculty/index.php?letter=L	incomplete
www.ics.uci.edu/faculty/index.php?letter=S	incomplete
www.ics.uci.edu/faculty/index.php?letter=R	incomplete
www.ics.uci.edu/faculty/index.php?letter=Q	incomplete
www.ics.uci.edu/faculty/index.php?letter=P	incomplete
www.ics.uci.edu/faculty/index.php?letter=W	incomplete
www.ics.uci.edu/faculty/index.php?letter=V	incomplete
www.ics.uci.edu/community/news/view_news?id=1148	incomplete
www.ics.uci.edu/community/news/view_news?id=1149	incomplete
www.ics.uci.edu/community/news/view_news.php?id=1272	incomplete
www.ics.uci.edu/faculty/index.php?letter=Z	incomplete
www.ics.uci.edu/community/news/view_news.php?id=1270	incomplete
www.ics.uci.edu/faculty/index.php?letter=X	incomplete
www.ics.uci.edu/community/news/view_news?id=1142	incomplete
www.ics.uci.edu/community/news/view_news?id=1143	incomplete
www.ics.uci.edu/community/news/view_news?id=1140	incomplete
www.ics.uci.edu/community/news/view_news?id=1141	incomplete
www.ics.uci.edu/community/news/view_news?id=1267	complete
www.ics.uci.edu/community/news/view_news?id=1266	incomplete
www.ics.uci.edu/community/news/view_news?id=1265	incomplete
www.ics.uci.edu/community/news/view_news?id=1264	incomplete
www.ics.uci.edu/community/news/view_news?id=1263	complete
www.ics.uci.edu/community/news/view_news?id=1262	complete
www.ics.uci.edu/community/news/view_news?id=1261	incomplete
www.ics.uci.edu/community/news/view_news?id=1260	incomplete
www.ics.uci.edu/~sternh	incomplete
www.ics.uci.edu/community/news/view_news?id=1269	incomplete
www.ics.uci.edu/community/news/view_news?id=1268	incomplete
mhcid.ics.uci.edu/admissions/online-information-sessions	incomplete
www.ics.uci.edu/~redmiles	incomplete
www.ics.uci.edu/prospective/en/student-life/bren-ics-organizations	incomplete
www.ics.uci.edu/~wangk7	incomplete
www.ics.uci.edu/computing/contact/who.php	complete
www.ics.uci.edu/prospective/ko/degrees/ics-undeclared-pre-major	incomplete
mhcid.ics.uci.edu	complete
www.ics.uci.edu/prospective/en/degrees/minors	complete
www.ics.uci.edu/faculty/profiles/view_faculty.php?ucinetid=lopes	incomplete
www.ics.uci.edu/faculty/index.php?letter=Y	incomplete
www.ics.uci.edu/~guoqingx	incomplete
www.ics.uci.edu/%7Elab	incomplete
www.ics.uci.edu/faculty/profiles/view_faculty.php?ucinetid=aihler	incomplete
www.ics.uci.edu/prospective/en/opportunities/honors	complete
www.ics.uci.edu/faculty/index.php?department=Informatics	incomplete
www.ics.uci.edu/faculty/profiles/view_faculty.php?ucinetid=bnan	incomplete
www.ics.uci.edu/computing/linux/gsu.php	complete
www.ics.uci.edu/~tmuck	incomplete
www.ics.uci.edu/prospective/zh-tw/degrees/minors	incomplete
mcs.ics.uci.edu/current-students/once-admitted/vv	incomplete
www.ics.uci.edu/computing/linux/sge.php	complete
www.ics.uci.edu/grad/admissions/Prospective_ApplicationProcess.php	complete
www.ics.uci.edu/community/news/view_news.php?id=1266	complete
www.pokemongo.com	incomplete
www.ics.uci.edu/ugrad/policies/Laptop_ComputerUse	complete
www.ics.uci.edu/~tkaczmar	incomplete
www.ics.uci.edu/grad/degrees/index	complete
www.ics.uci.edu/~taylor	incomplete
www.ics.uci.edu/prospective/ko/degrees/computer-science	incomplete
www.ics.uci.edu/~marios	incomplete
www.ics.uci.edu/prospective/zh-tw/degrees/ics-undeclared-pre-major	incomplete
www.nsf.gov/awardsearch/showAward?AWD_ID=1305430	incomplete
www.youtube.com/UCIBrenICS	incomplete
www.ics.uci.edu/about/kfflab	incomplete
www.ics.uci.edu/prospective/en/student-life/campus-involvement	incomplete
www.ics.uci.edu/faculty/profiles/view_faculty.php?ucinetid=mguindan	incomplete
dre.sourceforge.net	incomplete
www.ics.uci.edu/~qiuxiz	incomplete
www.ics.uci.edu/prospective/en/admissions/transfer	incomplete
www.ics.uci.edu/faculty/profiles/view_faculty.php?ucinetid=gopi	incomplete
www.ics.uci.edu/~kobsa	incomplete
www.se4s.org	incomplete
www.ics.uci.edu/~pfbaldi	incomplete
www.ics.uci.edu/prospective/ko/admissions/freshmen	incomplete
mcs.ics.uci.edu/prospective-students/cost-and-financial-aid	incomplete
mhcid.ics.uci.edu/program/events/career-conference	incomplete
www.ics.uci.edu/computing/account/activate.php	complete
www.ics.uci.edu/faculty/profiles/view_faculty.php?ucinetid=jpd	incomplete
www.ics.uci.edu/%7Elab/policies	incomplete
www.ics.uci.edu/~yliu	incomplete
www.ics.uci.edu/computing/services/printing.php	complete
www.ics.uci.edu/~dzhang3	incomplete
www.ics.uci.edu/computerscience	incomplete
www.ics.uci.edu/about/visit/index.php	complete
www.ics.uci.edu/community/news/view_news?id=1161	incomplete
www.ics.uci.edu/faculty/profiles/view_faculty.php?ucinetid=sternh	incomplete
www4.in.tum.de/~penzenst	incomplete
www.ics.uci.edu/~bic	incomplete
www.ics.uci.edu/faculty/profiles/view_faculty.php?ucinetid=iharris	incomplete
www.ics.uci.edu/prospective/vi/degrees/ics-undeclared-pre-major	incomplete
www.ics.uci.edu/community/news/student_blogs	complete
www.ics.uci.edu/~nardi	incomplete
www.ics.uci.edu/faculty/profiles/view_faculty.php?ucinetid=emilyo	incomplete
www.ics.uci.edu/ugrad/sao/SAO_Events.php	complete
www.ics.uci.edu/prospective/en/degrees/computer-science-engineering	complete
www.ics.uci.edu/faculty/profiles/view_faculty.php?ucinetid=babaks	incomplete
www.ics.uci.edu/faculty/profiles/view_faculty.php?ucinetid=gmark	incomplete
www.ics.uci.edu/~sajjadt	incomplete
www.ics.uci.edu/community/news/view_news?id=1200	incomplete
www.ics.uci.edu/~taow4	incomplete
www.ics.uci.edu/faculty/profiles/view_faculty.php?ucinetid=mbdillen	incomplete
www.ics.uci.edu/ugrad/policies/Withdrawal_Readmission	complete
www.ics.uci.edu/grad/forms/index	complete
www.ics.uci.edu/~wayne	incomplete
www.ics.uci.edu/ugrad/Academic%20Plan%20worksheet.pdf	incomplete
www.ics.uci.edu/community/news/view_news?id=1181	incomplete
www.ics.uci.edu/faculty/profiles/view_faculty.php?ucinetid=malek	incomplete
www.ics.uci.edu/~pattis	incomplete
www.ics.uci.edu/faculty/profiles/view_faculty.php?ucinetid=kobsa	incomplete
evoke.ics.uci.edu/newsite?page_id=219	incomplete
www.ics.uci.edu//intranet.ics.uci.edu/index.phtml?topic=%3CBIG%3EPlease+login%21%3C%2FBIG%3E%0A&state__=wcapp.help%2F%2F1518758068%2F%2F%2F%2F%2F%26b741eaa67f00e88163a221d83eb15ea9	incomplete
elnino.ics.uci.edu	incomplete
www.ics.uci.edu/community/news/view_news?id=1206	incomplete
www.ics.uci.edu/prospective/zh-tw/admissions/freshmen	incomplete
www.ics.uci.edu/%7eprojects/satware	incomplete
www.ics.uci.edu/~vpsaini	incomplete
www.ics.uci.edu/community/news/view_news?id=1195	incomplete
www.ics.uci.edu/community/news/view_news?id=1194	incomplete
www.ics.uci.edu/community/news/view_news?id=1197	incomplete
www.ics.uci.edu/community/news/view_news?id=1196	incomplete
www.ics.uci.edu/community/news/view_news?id=1191	incomplete
www.ics.uci.edu/community/news/view_news?id=1190	incomplete
www.ics.uci.edu/community/news/view_news?id=1218	incomplete
www.ics.uci.edu/community/news/view_news?id=1219	incomplete
www.ics.uci.edu/community/news/press/view_press?id=161	incomplete
www.ics.uci.edu/community/news/view_news?id=1217	incomplete
www.ics.uci.edu/prospective/zh-tw/contact/student-affairs	incomplete
www.ics.uci.edu/community/news/view_news?id=1215	incomplete
www.ics.uci.edu/community/news/view_news?id=1199	incomplete
www.ics.uci.edu/community/news/press/view_press?id=164	incomplete
www.ics.uci.edu/community/news/press/view_press?id=167	incomplete
www.ics.uci.edu/community/news/press/view_press?id=166	incomplete
www.ics.uci.edu/faculty/profiles/view_faculty.php?ucinetid=eppstein	incomplete
www.ics.uci.edu/faculty/profiles/view_faculty.php?ucinetid=yamingy	incomplete
www.ics.uci.edu/prospective/en/degrees/data-science	complete
www.ics.uci.edu/~ngallo1	incomplete
www.ics.uci.edu/~zbutler	incomplete
mhcid.ics.uci.edu/people/industry-advisory-board	incomplete
www.ics.uci.edu/faculty/profiles/view_faculty.php?ucinetid=givargis	incomplete
www.ics.uci.edu/faculty/profiles/view_faculty.php?ucinetid=elzarki	incomplete
www.ics.uci.edu/computing/account/renewal.php	complete
mcs.ics.uci.edu/career/additional-skills-resources	incomplete
www.ics.uci.edu/prospective/en	complete
mhcid.ics.uci.edu/faq	incomplete
www.ics.uci.edu/faculty/profiles/view_faculty.php?ucinetid=sjarecki	incomplete
www.ics.uci.edu/community/news/view_news?id=1289	incomplete
www.ics.uci.edu/community/news/view_news?id=1288	incomplete
www.ics.uci.edu/prospective/ko/careers/breadth	incomplete
www.ics.uci.edu/community/news/view_news?id=1281	incomplete
www.ics.uci.edu/community/news/view_news?id=1280	incomplete
www.ics.uci.edu/community/news/view_news?id=1283	incomplete
www.ics.uci.edu/community/news/view_news?id=1282	incomplete
www.ics.uci.edu/community/news/view_news?id=1285	incomplete
www.ics.uci.edu/community/news/view_news?id=1284	incomplete
www.ics.uci.edu/community/news/view_news?id=1287	incomplete
www.ics.uci.edu/prospective/en/admissions/financial-aid	incomplete
www.ics.uci.edu/community/news/view_news?id=1184	incomplete
www.ics.uci.edu/~huw5	incomplete
www.uci.edu/copyright.php	incomplete
www.ics.uci.edu/grad/degrees	incomplete
www.informatics.uci.edu	incomplete
www.ics.uci.edu/about/about_factsfigures.php	complete
www.ics.uci.edu/community/news/view_news?id=1151	incomplete
www.ics.uci.edu/~mlevorat/index.html	complete
ceng.usc.edu/~bkrishna	incomplete
www.ics.uci.edu/ugrad/courses/listing.php?year=2016&level=Lower-Division&department=STATS&program=ALL	incomplete
www.ics.uci.edu/community/news/view_news?id=1150	incomplete
mcs.ics.uci.edu/current-students/resources	incomplete
www.ics.uci.edu/faculty/profiles/view_faculty.php?ucinetid=jfeldman	incomplete
www.ics.uci.edu/community/news/view_news?id=1153	incomplete
www.ics.uci.edu/prospective/en/careers/internships	incomplete
gats.ics.uci.edu/tracker/index.php	incomplete
emj.ics.uci.edu/papers/computational-biology-papers	incomplete
www.ics.uci.edu/about/annualreport	complete
www.ics.uci.edu/community/news/view_news.php?id=1261	complete
www.ics.uci.edu/prospective/en/admissions/housing	incomplete
www.ics.uci.edu/grad/degrees/degree_cs.php	complete
www.ics.uci.edu/ugrad/policies/Academic_Integrity	complete
webmail.ics.uci.edu	complete
www.ics.uci.edu/faculty/profiles/view_faculty.php?ucinetid=hayesg	incomplete
www.ics.uci.edu/community/news/view_news.php?id=1263	complete
www.ics.uci.edu/community/news/view_news.php?id=1262	complete
www.ics.uci.edu//www.stat.uci.edu/news	incomplete
www.ics.uci.edu/computing/web/faqs.php	complete
www.ics.uci.edu/involved/project_class	complete
mcs.ics.uci.edu/current-students/mcs-grade-policy	incomplete
www.ics.uci.edu/faculty/profiles/view_faculty.php?ucinetid=ksalen	incomplete
www.ics.uci.edu/community/news/view_news?id=1253	incomplete
www.ics.uci.edu/ics/bin/pdf/grad/F17-17 Graduate Student Handbook.pdf	incomplete
www.ics.uci.edu/community/news/view_news?id=1136	incomplete
www.ics.uci.edu/ugrad/courses	complete
www.ics.uci.edu/prospective/ko/student-life/diversity	incomplete
www.ics.uci.edu/faculty/profiles/view_faculty.php?ucinetid=franz	incomplete
www.jcdcgg.u-tokai.ac.jp	incomplete
www.ics.uci.edu/faculty/area	complete
www.battlefield.com	incomplete
www.ics.uci.edu/community/news/view_news.php?id=1268	complete
www.ics.uci.edu/~tujohnso	incomplete
www.uci.edu	incomplete
www.ics.uci.edu/grad/forms	complete
www.ics.uci.edu/community/news/view_news?id=1255	incomplete
asterixdb.apache.org	incomplete
www.ics.uci.edu/%7elab/students/printing.php	incomplete
gats.ics.uci.edu//tracker	complete
www.ics.uci.edu/~kringlan	incomplete
www.ics.uci.edu/faculty/profiles/view_faculty.php?ucinetid=golson	incomplete
malek.ics.uci.edu	incomplete
www.ics.uci.edu/~zsshaikh	incomplete
mhcid.ics.uci.edu/admissions/information-session-2	incomplete
www.ics.uci.edu/about/visit/index	complete
www.ics.uci.edu/faculty/centers	complete
www.ics.uci.edu/~aburtsev	incomplete
www.ics.uci.edu/community/scholarships/index	complete
www.ics.uci.edu/community/news	complete
www.ics.uci.edu/computing/account	complete
www.ics.uci.edu/faculty/profiles/view_faculty.php?ucinetid=pjsmyth	incomplete
www.ics.uci.edu/~lueker	incomplete
www.ics.uci.edu/ugrad/degrees	complete
www.ics.uci.edu/~zhaoxia	incomplete
www.ics.uci.edu/prospective/ko/degrees/software-engineering	incomplete
www.ics.uci.edu/community/news/view_news?id=1189	incomplete
www.ics.uci.edu/faculty/profiles/view_faculty.php?ucinetid=dhirschb	incomplete
www.ics.uci.edu/grad/index	complete
www.ics.uci.edu/prospective/ko/degrees/computer-science-engineering	incomplete
docs.google.com/forms/d/e/1FAIpQLSc3pUksl4A4FmGU6ShQhhscL18BUPaWDCkvbKiM_faw0Ds9sg/viewform	incomplete
sherlock.ics.uci.edu	incomplete
www.ics.uci.edu/~ihler	incomplete
www.finalfantasyxv.com	incomplete
www.ics.uci.edu/~jutts	incomplete
www.ics.uci.edu/prospective/vi/degrees/computer-science	incomplete
mcs.ics.uci.edu/career/personal-branding-marketing	incomplete
www.ics.uci.edu/computing/policy/index.php	incomplete
www.ics.uci.edu/prospective/ko/opportunities/entrepreneurship	incomplete
www.ics.uci.edu/~gts	incomplete
www.ics.uci.edu/faculty/profiles/view_faculty.php?ucinetid=igassko	incomplete
www.ics.uci.edu	complete
www.ics.uci.edu/community/news/view_news.php?id=1265	incomplete
www.ics.uci.edu/prospective/ko/opportunities/applied-learning	incomplete
www.ics.uci.edu/community/news/view_news.php?id=1267	incomplete
www.ics.uci.edu/community/news/view_news?id=1152	incomplete
www.ics.uci.edu/community/news/view_news?id=1155	incomplete
www.ics.uci.edu/community/news/view_news?id=1154	incomplete
www.ics.uci.edu/community/news/view_news?id=1157	incomplete
www.ics.uci.edu/community/news/view_news?id=1156	incomplete
www.ics.uci.edu/community/news/view_news?id=1159	incomplete
www.ics.uci.edu/community/news/view_news?id=1158	incomplete
www.ics.uci.edu/community/news/view_news?id=1250	incomplete
www.ics.uci.edu/community/news/view_news?id=1251	incomplete
www.ics.uci.edu/community/news/view_news.php?id=1269	incomplete
www.ics.uci.edu/community/news/view_news?id=1257	incomplete
www.ics.uci.edu/community/news/view_news?id=1254	incomplete
www.ics.uci.edu/~aalsulim	incomplete
www.ics.uci.edu/prospective/zh-tw/degrees/data-science	incomplete
www.ics.uci.edu/~thornton	incomplete
vid.ics.uci.edu/lab-members/faculty/judith_full	incomplete
www.ics.uci.edu/prospective/ko/degrees/overview	incomplete
www.ics.uci.edu/~avinask1	incomplete
playoverwatch.com/en-us	incomplete
www.ics.uci.edu/~aftabh	incomplete
www.ics.uci.edu/faculty/profiles/view_faculty.php?ucinetid=jain	incomplete
swiki.ics.uci.edu	incomplete
www.ics.uci.edu/grad/policies/index	complete
www.ics.uci.edu/prospective/zh-tw/degrees/computer-science	incomplete
mailboss.ics.uci.edu	incomplete
gats.ics.uci.edu/tracker	incomplete
www.ics.uci.edu/ugrad/sao/index	complete
www.ics.uci.edu/faculty/profiles/view_faculty.php?ucinetid=wmt	incomplete
www.ics.uci.edu/prospective/vi/degrees/minors	incomplete
www.ics.uci.edu/~givargis	incomplete
www.nsf.gov	incomplete
www.ics.uci.edu/faculty/profiles/view_faculty.php?ucinetid=alfaro	incomplete
www.ics.uci.edu/~goodrich	incomplete
www.ics.uci.edu/faculty/profiles/view_faculty.php?ucinetid=jutts	incomplete
www.ics.uci.edu/faculty/profiles/view_faculty.php?ucinetid=lueker	incomplete
www.ics.uci.edu/computing/email/thunderbird_Gmail.php	complete
creativecommons.org/licenses/by-nc-sa/4.0	incomplete
www.ics.uci.edu/computing/email/thunderbird_setup.php	complete
www.ics.uci.edu/grad/policies	incomplete
www.cambridge.org/core/books/forbidden-configurations-in-discrete-geometry/0A90D6B522B1DFF59641F086F149EA45	incomplete
www.ics.uci.edu/~magda	incomplete
www.ics.uci.edu/faculty/index.php?department=Statistics	incomplete
www.ics.uci.edu/prospective/en/admissions/application-tips	incomplete
www.ics.uci.edu/prospective/en/uci/city-of-irvine	incomplete
www.ics.uci.edu/faculty/profiles/view_faculty.php?ucinetid=wjohnson	incomplete
duttgroup.ics.uci.edu/doku.php/projects	complete
mcs.ics.uci.edu/current-students/once-admitted	incomplete
www.ics.uci.edu/prospective/vi/degrees/informatics	incomplete
mhcid.ics.uci.edu/program/about-the-program	complete
twitter.com/UCIbrenICS	incomplete
www.ics.uci.edu/ugrad/QA_Petitions	complete
www.ics.uci.edu/community/news/view_news.php?id=1257	incomplete
www.ics.uci.edu/faculty/profiles/view_faculty.php?ucinetid=pfbaldi	incomplete
www.ics.uci.edu/faculty/profiles/view_faculty.php?ucinetid=dechter	incomplete
www.ics.uci.edu/computing/services/sophos_mac.php	complete
www.ics.uci.edu/community/news/view_news?id=1232	incomplete
asterix.ics.uci.edu	complete
www.ics.uci.edu/prospective/en/uci/bren-school	incomplete
www.ics.uci.edu/faculty/profiles/view_faculty.php?ucinetid=weinings	incomplete
www.ics.uci.edu/computing/email/google_apps.php	complete
2017.cccg.ca	incomplete
mhcid.ics.uci.edu/admissions/costs-and-financial-aid	incomplete
www.ics.uci.edu/~hstrong	incomplete
www.ics.uci.edu/computing/account/password.php	complete
mcs.ics.uci.edu/current-students/resources/forms	incomplete
www.smh.com.au/news/obituaries/a-world-of-teaching-and-numbers--times-two/2005/11/06/1131211943674.html	incomplete
www.ics.uci.edu/prospective/vi/degrees/business-information-management	incomplete
www.ics.uci.edu/prospective/en/degrees/business-information-management	complete
www.ics.uci.edu/about/search/search_graduate_all.php	complete
www.ics.uci.edu/~khanhtn1	incomplete
www.ics.uci.edu/computing/email/delivery_point.php	complete
www.ics.uci.edu/~wscacchi	incomplete
www.ics.uci.edu/~celustig	incomplete
www.ics.uci.edu/prospective/en/opportunities/entrepreneurship	complete
www.ics.uci.edu/faculty/profiles/view_faculty.php?ucinetid=gtsudik	incomplete
www.ics.uci.edu/faculty/index.php?department=Computer Science	incomplete
www.ics.uci.edu/faculty/profiles/view_faculty.php?ucinetid=anicolau	incomplete
www.pokemon-sunmoon.com/en-us	incomplete
www.ics.uci.edu/faculty/profiles/view_faculty.php?ucinetid=ssirani	incomplete
www.ics.uci.edu/involved/corporate_partner	complete
www.ics.uci.edu/~franklin	incomplete
www.ics.uci.edu/ugrad/degrees/index.php	complete
www.ics.uci.edu/~mengyaz1	incomplete
www.ics.uci.edu/prospective/en/careers/graduate-school	incomplete
mcs.ics.uci.edu/prospective-students/application-process	complete
www.ics.uci.edu/computing/web/personalpage.php	complete
www.ics.uci.edu/faculty/profiles/view_faculty.php?ucinetid=goodrich	incomplete
www.ics.uci.edu/~eli	incomplete
www.ics.uci.edu/community/scholarships/index.php	incomplete
www.ics.uci.edu/~eward	incomplete
www.ics.uci.edu/ugrad/courses/listing.php?year=2016&level=Graduate&department=STATS&program=ALL	incomplete
stardewvalley.net	incomplete
www.ics.uci.edu/faculty/profiles/view_faculty.php?ucinetid=lbic	incomplete
www.ics.uci.edu/~babaks	incomplete
soundcloud.com/uci-brenics	incomplete
www.ics.uci.edu/community/news/view_news?id=1193	incomplete
www.ics.uci.edu/faculty/profiles/view_faculty.php?ucinetid=kay	incomplete
www.ics.uci.edu/prospective/en/careers/job-opportunities	incomplete
www.ics.uci.edu/community/news/view_news?id=1117	complete
www.ics.uci.edu/prospective/ko/degrees/computer-game-science	incomplete
www.ics.uci.edu/dept	complete
www.ics.uci.edu/ugrad/policies	complete
www.ics.uci.edu/community/news/view_news?id=1216	incomplete
www.ics.uci.edu/~vazirani	incomplete
www.ics.uci.edu/~lopes	incomplete
www.ics.uci.edu/prospective/zh-tw/degrees/informatics	incomplete
www.ics.uci.edu/faculty/profiles/view_faculty.php?ucinetid=baldib	incomplete
www.ics.uci.edu/community/news/press/view_press?id=163	incomplete
www.ics.uci.edu/faculty/profiles/view_faculty.php?ucinetid=mmazmani	incomplete
www.ics.uci.edu/computing/services/sophos_win.php	complete
www.ics.uci.edu/prospective/en/degrees/overview	complete
www.ics.uci.edu/prospective/vi	complete
www.cs.uci.edu/wp-content/cs/uploads/ACD_3960-1.jpg	incomplete
www.ics.uci.edu/community/news/press/view_press?id=165	incomplete
www.ics.uci.edu/faculty/profiles/view_faculty.php?ucinetid=mjcarey	incomplete
www.ics.uci.edu/faculty/profiles/view_faculty.php?ucinetid=ardalan	incomplete
www.ics.uci.edu/community/news/view_news?id=1213	incomplete
www.ics.uci.edu/community/news/view_news?id=1168	incomplete
www.ics.uci.edu/community/news/view_news?id=1169	incomplete
www.ics.uci.edu/faculty/profiles/view_faculty.php?ucinetid=aburtsev	incomplete
www.ics.uci.edu/computing/account/mapdrive_mac.php	complete
www.ics.uci.edu/community/news/view_news?id=1210	incomplete
www.ics.uci.edu/community/news/view_news?id=1160	incomplete
www.ics.uci.edu/community/news/view_news.php?id=1255	incomplete
www.ics.uci.edu/community/news/view_news?id=1162	incomplete
www.ics.uci.edu/community/news/view_news?id=1163	incomplete
www.ics.uci.edu/community/news/view_news?id=1164	incomplete
www.ics.uci.edu/community/news/view_news?id=1165	incomplete
www.ics.uci.edu/community/news/view_news?id=1166	incomplete
www.ics.uci.edu/community/news/view_news?id=1167	incomplete
www.ics.uci.edu/community/news/view_news?id=1201	incomplete
mesl.ucsd.edu/spark	incomplete
www.ics.uci.edu/community/news/view_news?id=1203	incomplete
www.ics.uci.edu/community/news/view_news?id=1202	incomplete
www.ics.uci.edu/community/news/view_news?id=1205	incomplete
www.ics.uci.edu/community/news/view_news?id=1204	incomplete
www.ics.uci.edu/community/news/view_news?id=1207	incomplete
www.ics.uci.edu/prospective/vi/opportunities/honors	incomplete
www.ics.uci.edu/community/news/view_news?id=1209	incomplete
www.ics.uci.edu/community/news/view_news?id=1208	incomplete
www.ics.uci.edu/~amirr1	incomplete
www.ics.uci.edu/prospective/en/degrees/computer-game-science	complete
mcs.ics.uci.edu/about/curriculum	incomplete
www.ics.uci.edu/prospective/ko/degrees/business-information-management	incomplete
www.ics.uci.edu/faculty/index.php?letter=M	incomplete
www.ics.uci.edu/faculty/profiles/view_faculty.php?ucinetid=taylor	incomplete
mcs.ics.uci.edu/prospective-students/admissions-requirement	incomplete
www.ics.uci.edu/prospective/vi/degrees/overview	incomplete
www.ics.uci.edu/%7etheory	incomplete
www.ics.uci.edu/grad/resources	complete
www.ics.uci.edu/prospective/en/degrees/ics-undeclared-pre-major	complete
www.ics.uci.edu/faculty/profiles/view_faculty.php?ucinetid=dutt	incomplete
mcs.ics.uci.edu/about/the-program	incomplete
www.uci.edu/cgi-bin/phonebook	incomplete
www.ics.uci.edu/ugrad/policies/index.php	incomplete
www.ics.uci.edu/prospective/vi/uci/campus	incomplete
www.ics.uci.edu/faculty/area/index.php	incomplete
www.ics.uci.edu/~lmartie	incomplete
www.ics.uci.edu/faculty/profiles/view_faculty.php?ucinetid=aregan	incomplete
www.ics.uci.edu/faculty/index.php?letter=U	incomplete
www.ics.uci.edu/prospective/ko/uci/campus	incomplete
luci.ics.uci.edu	incomplete
www.ics.uci.edu/faculty/profiles/view_faculty.php?ucinetid=klefstad	incomplete
www.pcmag.com/news/357685/inside-darpas-hackfest-at-nasa-research-park	incomplete
www.ics.uci.edu/computing/email/mailboss.php	complete
www.ics.uci.edu/computing/policy/ethics.php	complete
www.ics.uci.edu/community/news/view_news?id=1146	incomplete
www.ics.uci.edu/community/news/view_news?id=1147	incomplete
www.ics.uci.edu/faculty/profiles/view_faculty.php?ucinetid=xhx	incomplete
www.ics.uci.edu/community/news/view_news?id=1144	incomplete
www.ics.uci.edu/computing/contact/helpdesk.php	complete
www.ics.uci.edu/community/news/view_news?id=1145	incomplete
www.ics.uci.edu/about/about_contact.php	complete
www.unchartedthegame.com/en-us/games/uncharted-4	incomplete
www.ics.uci.edu/faculty/profiles/view_faculty.php?ucinetid=vvazirani	incomplete
www.ics.uci.edu/community/news/view_news?id=1212	incomplete
www.ics.uci.edu/prospective/vi/careers/breadth	incomplete
www.ics.uci.edu/community/news/press/view_press?id=162	incomplete
www.ics.uci.edu/prospective/en/opportunities/research	complete
www.ics.uci.edu/prospective/zh-tw/degrees/computer-game-science	incomplete
mcs.ics.uci.edu/career/career-planning	incomplete
www.ics.uci.edu/~wjohnson	incomplete
